#module 0 size: 22 bs: 0.643537
1 2 3 4 11 13 14 19 22 35 42 45 46 51 52 54 55 79 92 98 103 112 
#module 0 size: 6 bs: 0.477749
5 29 90 93 96 100 
#module 1 size: 4 bs: 0.721407
20 21 23 95 
#module 2 size: 6 bs: 0.620364
28 77 81 93 97 107 
#module 3 size: 20 bs: 0.478966
1 2 3 4 11 13 19 22 35 45 46 51 52 54 55 79 92 98 103 112 
#module 0 size: 22 bs: 0.643537
1 2 3 4 11 13 14 19 22 35 42 45 46 51 52 54 55 79 92 98 103 112 
#module 0 size: 9 bs: 0.677984
11 13 14 19 45 51 54 55 103 
#module 1 size: 12 bs: 0.704709
5 29 31 34 35 77 85 90 93 96 100 108 
#module 2 size: 3 bs: 0.795224
30 59 75 
#module 0 size: 22 bs: 0.643537
1 2 3 4 11 13 14 19 22 35 42 45 46 51 52 54 55 79 92 98 103 112 
#module 1 size: 28 bs: 0.252307
1 2 3 4 9 10 11 12 23 26 27 41 42 43 46 53 57 62 63 70 74 86 91 92 94 98 99 112 
#module 0 size: 19 bs: 0.754521
1 2 3 4 11 13 14 19 22 35 45 51 52 54 55 79 98 103 112 
#module 0 size: 26 bs: 0.759702
1 2 3 4 10 11 12 13 14 19 22 23 35 42 45 46 51 53 54 55 67 74 92 98 103 112 
#module 1 size: 3 bs: 0.795225
30 59 75 
#module 0 size: 22 bs: 0.838541
1 2 3 4 11 13 14 19 22 35 42 45 46 51 52 54 55 79 92 98 103 112 
#module 0 size: 6 bs: 0.620363
28 77 81 93 97 107 
#module 1 size: 20 bs: 0.800749
8 11 13 19 22 35 45 51 52 54 55 58 67 68 69 71 76 79 88 103 
