#module 0 size: 49 bs: 0.12664
1 2 3 4 5 6 7 8 9 10 11 12 13 14 15 16 17 18 19 20 21 22 23 24 25 26 27 28 30 33 34 35 36 37 38 39 40 41 42 43 44 45 46 47 48 54 55 56 57 
#module 1 size: 16 bs: 0.600719
10 21 49 50 51 52 53 58 59 65 66 68 69 70 104 105 
#module 2 size: 41 bs: 0.727884
29 31 32 60 61 62 63 64 67 71 72 73 74 75 76 77 78 79 80 81 82 83 84 85 87 88 89 90 91 92 93 94 95 96 97 98 99 100 101 102 103 
#module 0 size: 37 bs: 0.684742
4 9 10 11 12 13 14 15 18 19 21 22 23 24 25 26 27 28 33 34 35 36 37 38 39 40 41 42 43 44 45 46 47 48 51 54 55 
#module 1 size: 6 bs: 0.591461
4 11 16 17 20 56 
#module 2 size: 12 bs: 0.696657
1 2 3 4 5 6 7 8 15 23 26 30 
#module 3 size: 5 bs: 0.687491
10 21 49 50 58 
#module 4 size: 41 bs: 0.727885
29 31 32 60 61 62 63 64 67 71 72 73 74 75 76 77 78 79 80 81 82 83 84 85 87 88 89 90 91 92 93 94 95 96 97 98 99 100 101 102 103 
#module 5 size: 11 bs: 0.797749
52 53 59 65 66 68 69 70 86 104 105 
#module 0 size: 16 bs: 0.60072
10 21 49 50 51 52 53 58 59 65 66 68 69 70 104 105 
#module 1 size: 40 bs: 0.187547
4 9 10 11 12 13 14 15 16 17 18 20 21 22 23 24 25 26 27 28 33 34 35 36 37 38 39 40 41 42 43 44 45 46 47 48 54 55 56 57 
#module 2 size: 41 bs: 0.727885
29 31 32 60 61 62 63 64 67 71 72 73 74 75 76 77 78 79 80 81 82 83 84 85 87 88 89 90 91 92 93 94 95 96 97 98 99 100 101 102 103 
#module 3 size: 8 bs: 0.718179
1 2 3 5 6 7 8 30 
#module 0 size: 8 bs: 0.718179
1 2 3 5 6 7 8 30 
#module 1 size: 42 bs: 0.19216
4 7 9 10 11 12 13 14 15 16 17 18 19 21 22 23 24 25 26 27 28 30 33 34 35 36 37 38 39 40 41 42 43 44 45 46 47 48 51 54 55 56 
#module 2 size: 5 bs: 0.0368285
10 21 49 50 58 
#module 3 size: 9 bs: 0.675565
8 52 59 65 66 68 69 70 86 
#module 4 size: 44 bs: 0.750742
29 31 32 60 61 62 63 64 67 68 71 72 73 74 75 76 77 78 79 80 81 82 83 84 85 87 88 89 90 91 92 93 94 95 96 97 98 99 100 101 102 103 104 105 
#module 0 size: 8 bs: 0.146384
1 2 3 5 6 7 8 30 
#module 1 size: 5 bs: 0.0445971
10 21 49 50 58 
#module 2 size: 15 bs: 0.270294
8 15 31 52 53 59 65 66 67 68 69 70 86 104 105 
#module 3 size: 6 bs: 0.41486
4 11 16 17 20 56 
#module 4 size: 12 bs: 0.616215
9 14 33 34 35 36 38 39 40 43 44 45 
#module 5 size: 23 bs: 0.229173
4 9 10 12 13 14 15 18 21 23 24 25 26 27 28 41 42 45 46 47 48 54 55 
#module 6 size: 19 bs: 0.684057
31 32 71 72 73 74 75 76 77 78 79 80 81 83 84 88 92 93 99 
#module 7 size: 21 bs: 0.382516
60 61 62 63 64 67 74 82 85 87 89 90 94 95 96 97 98 100 101 102 103 
#module 0 size: 13 bs: 0.660538
1 2 3 4 5 6 7 8 15 19 23 26 30 
#module 1 size: 18 bs: 0.290083
9 11 13 14 22 24 33 34 35 36 37 38 39 40 41 43 44 45 
#module 2 size: 5 bs: 0.68749
11 16 17 20 56 
#module 3 size: 26 bs: 0.840865
9 10 12 13 14 15 18 21 25 27 28 41 42 43 44 45 46 47 48 49 50 51 54 55 57 58 
#module 4 size: 53 bs: 0.69935
8 29 31 32 52 53 59 60 61 62 63 64 65 66 67 68 69 70 71 72 73 74 75 76 77 78 79 80 81 82 83 84 85 86 87 88 89 90 91 92 93 94 95 96 97 98 99 100 101 102 103 104 105 
#module 0 size: 51 bs: 0.0612333
1 2 3 4 5 6 7 8 9 10 11 12 13 14 15 16 17 18 19 20 21 22 23 24 25 26 27 28 30 33 34 35 36 37 38 39 40 41 42 43 44 45 46 48 49 50 54 55 56 57 58 
#module 1 size: 50 bs: 0.78838
29 31 32 59 60 61 62 63 64 65 66 67 68 69 70 71 72 73 74 75 76 77 78 79 80 81 82 83 84 85 86 87 88 89 90 91 92 93 94 95 96 97 98 99 100 101 102 103 104 105 
#module 0 size: 3 bs: 0.605137
68 104 105 
#module 1 size: 13 bs: 0.660538
1 2 3 4 5 6 7 8 15 19 23 26 30 
#module 2 size: 5 bs: 0.631958
11 16 17 20 56 
#module 3 size: 22 bs: 0.840864
4 9 10 12 13 14 15 18 21 24 25 27 28 33 41 42 45 46 47 48 54 55 
#module 4 size: 7 bs: 0.679976
11 34 35 36 38 39 40 
#module 5 size: 5 bs: 0.68749
10 21 49 50 58 
#module 6 size: 12 bs: 0.799718
8 10 15 51 52 53 59 65 66 69 70 86 
#module 7 size: 37 bs: 0.339063
29 31 32 50 60 61 63 64 67 71 72 73 74 75 76 77 78 79 80 81 82 83 84 85 87 88 89 90 91 92 93 94 97 98 99 100 101 
#module 8 size: 6 bs: 0.833588
62 94 95 96 102 103 
#module 0 size: 44 bs: 0.750741
29 31 32 60 61 62 63 64 67 68 71 72 73 74 75 76 77 78 79 80 81 82 83 84 85 87 88 89 90 91 92 93 94 95 96 97 98 99 100 101 102 103 104 105 
#module 1 size: 9 bs: 0.291701
52 53 59 65 66 68 69 70 86 
#module 2 size: 10 bs: 0.831596
11 16 17 20 35 36 38 39 40 56 
#module 3 size: 39 bs: 0.698773
1 2 3 4 5 6 7 8 9 10 12 13 14 15 18 19 21 22 23 24 25 26 27 28 30 33 41 42 43 44 45 46 48 49 50 54 55 57 58 
#module 0 size: 13 bs: 0.660538
1 2 3 4 5 6 7 8 15 19 23 26 30 
#module 1 size: 5 bs: 0.840865
11 16 17 20 56 
#module 2 size: 20 bs: 0.846687
4 9 10 12 13 15 18 21 22 24 25 27 28 41 42 46 47 48 54 55 
#module 3 size: 7 bs: 0.0452068
11 34 35 36 38 39 40 
#module 4 size: 5 bs: 0.32905
10 21 49 50 58 
#module 5 size: 12 bs: 0.0452068
8 10 15 51 52 53 59 65 66 69 70 86 
#module 6 size: 44 bs: 0.750741
29 31 32 60 61 62 63 64 67 68 71 72 73 74 75 76 77 78 79 80 81 82 83 84 85 87 88 89 90 91 92 93 94 95 96 97 98 99 100 101 102 103 104 105 
